1, 9, 1, 1, 1, 1, 1, 1, 1
1, 0, 0, 0, 0, 0, 1, 0, 1
1, 1, 1, 0, 1, 0, 1, 0, 1
1, 0, 0, 0, 1, 0, 0, 0, 1
1, 1, 1, 1, 1, 1, 1, 0, 1
1, 0, 1, 0, 1, 0, 0, 0, 1
1, 0, 1, 0, 1, 0, 1, 1, 1
1, 0, 0, 0, 6, 6, 1, 0, 1
1, 0, 1, 1, 1, 0, 1, 0, 1
1, 0, 1, 5, 5, 0, 0, 0, 1
1, 1, 1, 1, 1, 1, 1, 8, 1
